------------------------------------------------------------------------------------------------------------------------------------------------------
------------------------------------------------------------------------------------------------------------------------------------------------------
------------------------------------------------------------------------------------------------------------------------------------------------------
------------------------------------------------------------------------------------------------------------------------------------------------------
------------------------------------------------------------------------------------------------------------------------------------------------------
----------oo--o-----------------------------ooo-------oo------oo------------oo--------oo--------------------------------------------------------------
--SSSSSS-------------------------%%%%-%%%%%-----------S--------------------%%%%------------------SSSSS------------------------------------------SSSSS-
-----------------------------------|---|||----------------------------------||------------------------------------------------------------------------
---------------------%%%%%%%-------|--|-||----------------------------------||------------------------------------%%%%%--------------S-------------#--
----------------------|||||-----------||||--------------------------|-------||---------------%%%%---------------oo||||-----------------------------#--
-------%%%%%%---------|||||----%%%%%%%%%|--------SSS----------------||---%%%%%----------------||---------%%%%%--%%||||-----------------------------#--
--------||||----------||||||----|||||||||--------------------#------||----||||----------------||----------||||--|-||||-----------------------------#--
--------||||-%%%------||||||----||||||||----------------------------||-|--||||--------%%%%%%%-||----------||||--||||||-------------|------------------
-M------||||||-----%%%||||||----||||||||---------------------#------||-|--||||--------||||||--||----------||||---|||||-------------|---------------#XX
XXXXX%%-|||||||------|||||||----||||||||-XXXXX----%%---XXXXXXXXXXXX-||||--||||--------||||||--||-%%%%%%%%-|-||---|||||-----%%%----||XXXXXXXXXXXXXXXXXX
X-XX%%--||||||------||-|||||----||||||||--XXXX-----|----XXXXXXXXXXX-||||--||||--------||||||--||----|%-%%%|-||---|||||------|-----||X-XXXXXXX-XXXXXXXX